r,d,0,0,0,0,0,0,0,0,0,0,0
0,d,0,0,0,0,0,0,r,r,d,0,0
0,d,0,0,0,0,r,r,u,0,d,0,0
0,r,r,r,d,0,u,0,0,0,d,0,0
0,0,0,0,d,0,u,0,0,0,d,0,0
0,0,0,0,d,0,u,0,0,0,d,0,0
0,0,0,0,r,r,u,0,0,0,r,r,e