r,d,0,r,r,d,0,0,0,0,0,0,0
0,d,0,u,0,d,0,0,r,r,d,0,0
0,d,0,u,0,r,r,r,u,0,d,0,0
d,l,0,u,0,0,0,0,0,0,d,0,0
d,0,0,u,0,0,d,l,l,l,l,0,0
d,0,0,u,0,0,d,0,0,0,0,0,0
d,0,0,u,0,0,d,0,0,0,r,r,e
d,0,0,u,0,0,r,r,r,r,u,0,0
d,0,0,u,0,0,0,0,0,0,0,0,0
d,0,0,u,l,l,l,l,l,l,l,l,0
d,0,0,0,0,0,0,0,0,0,0,u,0
r,r,r,r,r,r,r,r,r,r,r,u,0